[
  {
    "name": "Ferox Enclave",
    "areaId": "area.ferox_enclave",
    "levels": [0],
    "polygons": [
      {
        "vertices": [
          { "x": 3143, "z": 3618 },
          { "x": 3138, "z": 3618 },
          { "x": 3138, "z": 3616 },
          { "x": 3131, "z": 3617 },
          { "x": 3131, "z": 3618 },
          { "x": 3126, "z": 3618 },
          { "x": 3126, "z": 3618 },
          { "x": 3126, "z": 3622 },
          { "x": 3123, "z": 3622 },
          { "x": 3123, "z": 3633 },
          { "x": 3125, "z": 3633 },
          { "x": 3125, "z": 3640 },
          { "x": 3138, "z": 3639 },
          { "x": 3138, "z": 3647 },
          { "x": 3156, "z": 3647 },
          { "x": 3156, "z": 3640 },
          { "x": 3155, "z": 3640 },
          { "x": 3155, "z": 3636 },
          { "x": 3155, "z": 3633 },
          { "x": 3156, "z": 3626 },
          { "x": 3152, "z": 3626 },
          { "x": 3152, "z": 3623 },
          { "x": 3149, "z": 3623 },
          { "x": 3149, "z": 3620 },
          { "x": 3143, "z": 3620 },
          { "x": 3143, "z": 3618 }
        ]
      }
    ]
  }
]
