[
  {
    "name": "Wilderness",
    "areaId": "area.wilderness",
    "levels": [0, 1, 2, 3],
    "includes": [
      "area.wilderness_dungeons",
      "area.minor_wilderness_bosses_dungeons",
      "area.demonic_ruins",
      "area.chaos_temple"
    ],
    "polygons": [
      {
        "vertices": [
          { "x": 2947, "z": 3681 },
          { "x": 2947, "z": 3676 },
          { "x": 2944, "z": 3676 },
          { "x": 2944, "z": 3525 },
          { "x": 2994, "z": 3525 },
          { "x": 2997, "z": 3528 },
          { "x": 2998, "z": 3535 },
          { "x": 3002, "z": 3538 },
          { "x": 3003, "z": 3541 },
          { "x": 3007, "z": 3545 },
          { "x": 3012, "z": 3544 },
          { "x": 3015, "z": 3544 },
          { "x": 3019, "z": 3546 },
          { "x": 3022, "z": 3545 },
          { "x": 3027, "z": 3540 },
          { "x": 3029, "z": 3535 },
          { "x": 3031, "z": 3531 },
          { "x": 3037, "z": 3525 },
          { "x": 3342, "z": 3525 },
          { "x": 3344, "z": 3529 },
          { "x": 3348, "z": 3534 },
          { "x": 3352, "z": 3535 },
          { "x": 3362, "z": 3533 },
          { "x": 3372, "z": 3528 },
          { "x": 3395, "z": 3528 },
          { "x": 3395, "z": 3984 },
          { "x": 2944, "z": 3986 },
          { "x": 2944, "z": 3684 }
        ]
      }
    ]
  }
]
